wwwwwwwwwwwwwwwwwwww
w..................w
w..................w
w..................w
w..................w
w..................w
w.........s........w
w..................w
w..................w
w..................w
w..................w
w..................w
w..................w
w..................w
w..................w
w..................w
w..................w
w..................w
w.................fw
wwwwwwwwwwwwwwwwwwww
cccccccccccccccccccc