mmmmmmmmmmmmmmmmmmmm
md00000m0000m000000m
m000mm000mm000mm000m
m000m00m0000m00m000m
m000000m0000m000000m
m00000mmmmmmmm00000m
m000000000000000000m
m00000mmm00mmm00000m
m00000m000000m00000m
m00000m0m00m0m00000m
m00000m000000m00000m
m00000mmm00mmm00000m
m000000000000000000m
m00000mmmmmmmm00000m
m000000m0000m000000m
m000m0000000000m000m
m000mm000mm000mm000m
m000000m0000m000000m
m000000m0000m00000am
mmmmmmmmmmmmmmmmmmmm
cccccccccccccccccccc