wwwwwwwwwwwwwwwwwwww
ws...............w.w
w..wwwwwwwwwwwwww..w
w.w..w........w..w.w
w..w..w......w..w..w
w...w..w....w..w...w
w..w...w....w...w..w
w.w....w....w....w.w
w..w.........w..w..w
w...w..w....w..w...w
w..w...w....w...w..w
w......w....w......w
w..w..w......w..w..w
w...w..w....w..w...w
w..w...w....w...w..w
w......w....w....w.w
w..w..w.........w..w
w...w..w....w..w...w
w..w...w....w...wf.w
wwwwwwwwwwwwwwwwwwww
cccccccccccccccccccc