mmmmmmmmmmmmmmmmmmmm
md0m0000mm0000mm000m
m0m00mm00m00m00m0m0m
m00m00m0m00m00m00m0m
m0m00mm00m00m00m0m0m
m00m00m0m00m00m0000m
m0m00mm00m00m00m0m0m
m00m00m0m00m00m0000m
m0m00mm00m00m00m0m0m
m00m00m0m00m00m00m0m
m0m00mm00m00m00m000m
m00m00m0m00m00m00m0m
m0m00mm00m00m00m0m0m
m00m00m0m00m00m0000m
m0m00mm00m00m00m0m0m
m00m00m0m00m00m00m0m
m0m00mm00m00m00m0m0m
m00m00m0m00m00m00m0m
m0000m0000m000000mam
mmmmmmmmmmmmmmmmmmmm
cccccccccccccccccccc