wwwwwwwwwwwwwwwwwwww
ws...........w.....w
w..w..w..w..w..w..ww
ww..w..w..w..w..w..w
w..w..w..w..w..w..ww
ww..w..w..w..w..w..w
w..w..w..w..w..w..ww
ww.................w
w..w..w..w..w..w..ww
ww..w..w..w..w..w..w
w..w..w..w..w..w..ww
ww..w..w..w..w..w..w
w.ww..w..w..w..w..ww
ww.................w
w..w..w..w..w..w..ww
ww..w..w..w..w..w..w
w..w..w..w..w..w..ww
ww..w..w..w..w..w..w
w.....w.....w.....fw
wwwwwwwwwwwwwwwwwwww
cccccccccccccccccccc